9 9
4 5
1 1 1 1 1 1 1 1 1
1 1 1 1 1 1 1 1 1
1 1 1 3 1 1 1 1 1
1 1 1 0 1 1 1 1 1
1 1 1 2 0 2 3 1 1
1 3 0 2 0 1 1 1 1
1 1 1 1 2 1 1 1 1
1 1 1 1 3 1 1 1 1
1 1 1 1 1 1 1 1 1


